  #####
###   #
#xpo  #
### ox#
#x##o #
# # x ##
#o oxox#
#   ox #
########
